
C 150,150,255
F 100, 000001,100
SO ./../img/xpm/wall.xpm
NO /Users/iqabbal/Desktop/cuba-main/cud3d/img/xpm/wall.xpm
WE ./../img/xpm/wall.xpm
EA ./../img/xpm/wall.xpm

11111111111111111
1000001000000011
1110001111111111111111111111111111
100E001000000000000001000000000001
1000000000000000000000000111111111
1111111111111111111111111111111111                                                   