
C 150,150,255
F 100, 000001,100
SO ./../img/xpm/wall.xpm
NO /Users/iqabbal/Desktop/cuba-main/cud3d/img/xpm/wall.xpm
WE ./../img/xpm/wall.xpm
EA ./../img/xpm/wall.xpm

1111111111111111
1000001000000011
11100011111111111111111111
100E0011000000000000010001
10000010000000000000000001
1111111111111111111111111111111111
