
C 150,150,255
F 100, 000001,100
SO ./../img/xpm/wall.xpm
NO /Users/iqabbal/Desktop/cuba-main/cud3d/img/xpm/wall.xpm
WE ./../img/xpm/wall.xpm
EA ./../img/xpm/wall.xpm

11111111111
10000000001
10E00000001
10000000001
11111111111