
C 150,150,255
F 100, 000001,100
SO ./../texture/SO.xpm

NO ./../texture/NO.xpm
WE ./../texture/WE.xpm
EA ./../texture/EA.xpm

1111111111111111
100000100000001
1000011111111111111111111
100E0011000000000000010001
10000010000000000000000001
1111111111111111111111111111111111